1 13 31
###############################
#p           b               x#
#            *          1     #
#            f                #
#            *                #
#            b      2  3      #
#            *                #
#            s                #
#            *                #
#            5                #
#            *                #
#x           f          4    x#
###############################