2 13 16
################
#p     **#  s  #
# # 1*#  #  #*##
#    * 2  1*** #
# # # # #   *# #
#f    b # 4  **#
# # # #  # # # #
#*  *   s  *  *#
# # # #   *#*  #
#*  3 **  *   5#
# #*# # # #f# ##
#      b    * m#
################