2 13 31
###############################
#p     **#      * 2 *  *#* *  #
# #  *#  #  #*##  # # # *     #
#  x * 1   ***  *     * 2 * * #
# # # # #   *# # #*#* # # # #*#
#f      #  x **  *  *   1     #
# # # #  # # #  #  #  #  #  # #
#*  *   s  *  *      *        #
# # # #   *#*  *#*  #*# # # # #
#*    **  *   1   *           #
# #*# # # # # # #*# # # # # # #
#      b    *                 #
###############################